                                                                 
                                                                    *------------------------------*
                                                                    |      O JOGADOR DA VER É      |
                                                                    *-------*-------------*--------*
                                                                            { }
                                                                            *-------------*
                                                                    *-------------------------------*
                                                                    |       FAÇA SEU MOVIMENTO      |
                                                                    *-------------------------------* 